+++++++++++++++++++++++++++++++++++++++++++++++
++++                                       ++++
++++                                       ++++
++++                                       ++++
++++     +++++++++++++++++++++++++++++     ++++
++++     +++++++++++++++++++++++++++++     ++++
++++     +++++++++++++++++++++++++++++     ++++
++++                                       ++++
++++                                       ++++
++++                                       ++++
+++++++++++++++++++++++++++++++++++++++++++++++